111111111111111111111111111111111111111111111111111111111111111
100000000000000000000000000000000000000000000000000000000000001
100000000000000000000000000000000000000000000000000000000000001
100000000060000000000000000000000000000000000000000000000000001
100000000000000000000000000000000000000000000000000000000000001
100000000001111111111111000000000007000000000000000000000000001
100000000001333333333331000000000000000000000000000000000000001
100000000001333333333331000000000000000000000000000000000000001
100000000003333333333331000000000000000000000000000000000000001
100000000003333333333341000000000000000000000000000000000000001
100000000003333333333331000000000000000000000000000000000000001
100000000001333333333331000000000000000000000000000000000000001
100000000001333333333331000000000000000000000000000000000000001
100000000001333333333331000000000000000000000000000000000000001
100000000001111111111111000000000000000000000000000000000000001
100000000000000000000000000000000000000000000000000000000000001
100000000000000000000000000000000000000000000000000000000000001
100000000000000000000000000000000000000000000000000000000000001
100000000000000000000000000000000000000000000000000000000000001
100000000000000000000000000000000000000000000000000000000000001
100000000000000000000000000000000000000000000000000000000000001
100000000000000000000000000000000000000000000000000000000000001
100000000000000000000000000000000000000000000000000000000000001
100000000000000000000000000000000000000000000000000000000000001
100000000000000000000000000000000000000000000000000000000000001
100000000000000000000000000000000000000000000000000000000000001
100000000000000000000000000000000000000000000000000000000000001
100000000000000000000000000000000000000000000000000000000000001
100000000000000000000000000000000000000000000000000000000000001
100000000000000000000000000000000000000000000000000000000000001
100000000000000000000000000000000000000000000000000000000000001
100000000000000000000000000000000000000000000000000000000000001
100000000000000000000000000000000000000000000000000000000000001
100000000000000000000000000000000000000000000000000000000000001
100000000000000000000000000000000000000000000000000000000000001
111111110011111111111111100000000000000000000000000000000000001
100000000000000000000000100000000000000000000000000000000000001
100000000000000000000000100000000000000000000000000000000000001
100000000000000000000000100000000000000000000000000000000000001
100000000000000000000000100000000000000000000000000000000000001
100000000000000000000000100000000000000000000000000000000000001
100000000000000000000000100000000000000000000000000000000000001
100000000000000000000000000000000000000000000000000000000000001
100000000000000000000000000000000000000000000000000000000000001
100000000000000000000000100000000000000000000000000000000000001
100000000000000000000000100000000000000000000000000000000000001
100000000000000000000000100000000000000000000000000000000000001
111111111111111111111111111111111111111111111111111111111111111